111111111111
100E0P000001
10C000000001
100000000001
100000000001
100000000001
111111111111