11111111111111111111111111111111
10000000000000100000C00000000001
1000000000001E100000000000000P01
10000000000001000000000000000001
1C00000000000000000000C000000001
11111111111111111111111111111111