1111111
100E0P1
10C0001
1111111