11111111111111111111111111111
100E0P00000000000000000M0C001
10C00000000000000000000001111
1000001000000C000000000000001
11100100000000000000M00000001
10000010000000000000000000001
10000M000M00000000M0000000001
10000000000000000000000000001
11111111111111111111111111111